          SO      ./path_to_the_north_texture.xpm



EA ./path_to_the_east_texture.xpm
NO      ./path_to_the_north_texture.xpm 
    F    220,   100,      02


    C    220,   100,      102
             R      500         500


    WE     ./path_to_the_west_texture.xpm


   S     ./path_to_the_west_texture.xpm        


111111
1000001
1111111


